txid,playerid,itemid,shopid,invid,balanceid,cost
1,1,1,1,1,1,50
2,1,5,1,1,2,30
3,1,3,1,1,3,500
4,2,2,1,1,4,15
5,2,6,1,1,5,150
6,2,3,1,1,6,500
7,3,5,1,1,7,30
8,3,7,1,1,8,100
9,4,4,1,1,9,30
10,4,8,1,1,10,200
11,5,10,1,1,11,200
12,5,5,1,1,12,30
